[
  {
    "type": "mapgen",
    "method": "json",
    "om_terrain": [ [ "pangaea_FIELD_1", "pangaea_FIELD_2" ], [ "pangaea_FIELD_3", "pangaea_FIELD_4" ] ],
    "object": {
      "fill_ter": "t_linoleum_white",
      "rows": [
        "..............#############################.....",
        "...!.......!..#,,,,,#bbbbbb#,,uuuu,MMM,OOO#.....",
        "..............#,,,,,#,,,,,,#,,,,,,,MCM,,,,#...!.",
        "..............#,,,,,#,,,,,,#,,,,//,,,,,,,,#.....",
        "..............#^,,,,#,,,,,,#/,,,//,,,,,,,,#.....",
        "..........!...#^,,,,D,,,,,,#/m,,//,////,,,#!....",
        "...!..........#^,,,,#,,,,,,#/,,,//,////,,u#.....",
        "..............#,,,,,#,,,,,b#/m,,,,,,,,,,uM#.....",
        ".........!....#,,,,,#b,,,,b#/,n,n,,,,,,,,V#.....",
        ".............1#,,,,,#b,,,,b#//////VV,,,,,,#1....",
        "#####################b,,,,b##########D##########",
        "#,HHHHHHHHHHHFFFFF,,#b,,,,b#s/////sFF,FFs/////s#",
        "#,,,,,,,,,,,,,,,,,,,#b,,,,,#,,,,,,,,,,,,,,,,,,,#",
        "#,HHHHHHHHHHHFFFFF,,#,,,,,,D,,,,,,,,,,,,,,,,,,,#",
        "#,,,,,,,,,,,,,,,,,,,D,,,,,,D,,,,,,,,,,,,,,,,,,,#",
        "#,,,,,,,,,,,,,,,,,,,D,,,,,,#,,,,,,,,,,,,,,,,,,,#",
        "#,HHHHHHHHHHHFFFFF,,#,,,,,b#s/////sFF,FFs/////s#",
        "#,,,,,,,,,,,,,,,,,,,#b,,,,b##########D##########",
        "#,HHHHHHHHHHHFFFFF,,#b,,,,b#//////VV,,,,,,#.....",
        "#####################b,,,,b#/,v,v,,,,,//,,#.....",
        "#,ccc,,,,,,f/#t#t#t####DD###/m,,,,,,,,//,,#.....",
        "w,eee,,hhh,,/#d#d#d##l,,,,l#/,,,////,,//,,#.....",
        "w,,,,,,zzz,,/#,,,,,s#l,,,,l#/m,,////,,//,,#.....",
        "w,,,,,,zzz,,,d,bbb,s#l,,,,l#/,,,,,//,,,,,,#.!...",
        "w,,,,,,hhh,,,#,,,,,s#l,,,,l#u,,,,,,,,,,,MM#.....",
        "w,,,,,,,,,,,,#d#d#d##l,,,,l#u,,MCM,,u,,MMM#.....",
        "#llllll,,TTTT#S#S#S##l,,,,l#u,,MMM,VMu,MMM#.....",
        "########d#############D####################.....",
        "wb,bb,b,,,,,,,,,,,,,#,,,#xxxxxxxxxxxxxxxxxxxxxxx",
        "wb,bb,b,,,,,,,,,,,,,D,,,#xxxxxxxxxxxxxxxxxxxxxxx",
        "wb,bb,b,,,,,,,,,,,,,#,,,#xxxxxxxxxxxxxxxxxxxxxxx",
        "wb,bb,b,,,,,,,###d#######xxxxxxxxxxxxxxxxxxxxxxx",
        "wb,bb,b,,,,,,b#BB,TY#1..-yyyyyyxxxxxxxxxxxyyyyyy",
        "wb,bb,b,,,,,,b#,,,,_#...-xxxxxxxxxxxxxxxxxxxxxxx",
        "wb,bb,b,,,,,,b#,,,h_#...-xxxxxxxxxxxxxxxxxxxxxxx",
        "w,,,,,,,,,,,,b#_____#...-xxxxxxxxxxxxxxxxxxxxxxx",
        "###d#[[[[[##d##wwwww#...-xxxxxxxxxxxxxxxxxxxxxxx",
        "w,,,,,,,__[,,,#.........-yyyyyyxxxxxxxxxxxyyyyyy",
        "w,T,T,T,h_[,,,#.......!.-xxxxxxxxxxxxxxxxxxxxxxx",
        "w,T,T,T,,_[,,,#.........-xxxxxxxxxxxxxxxxxxxxxxx",
        "w,T,T,T,,_#wdw#.........-xxxxxxxxxxxxxxxxxxxxxxx",
        "w,T,T,T,,_#---....!.....-xxxxxxxxxxxxxxxxxxxxxxx",
        "###########.-...........-yyyyyyxxxxxxxxxxxyyyyyy",
        "............-...........-xxxxxxxxxxxxxxxxxxxxxxx",
        "..!.........-...........-xxxxxxxxxxxxxxxxxxxxxxx",
        "............-------------xxxxxxxxxxxxxxxxxxxxxxx",
        ".........!..............-xxxxxxxxxxxxxxxxxxxxxxx",
        "........................-yyyyyyxxxxxxxxxxxyyyyyy"
      ],
      "palettes": [ "palette_pangaea_FIELD" ],
      "place_item": [
        { "item": "microscope", "x": 28, "y": 5 },
        { "item": "microscope", "x": 28, "y": 7 },
        { "item": "microscope", "x": 30, "y": 9 },
        { "item": "microscope", "x": 32, "y": 9 },
        { "item": "microscope", "x": 28, "y": 20 },
        { "item": "microscope", "x": 28, "y": 22 },
        { "item": "microscope", "x": 30, "y": 18 },
        { "item": "microscope", "x": 32, "y": 18 },
        { "item": "DNA_analyzer", "x": 40, "y": 7 },
        { "item": "gaia_nest", "x": 36, "y": 25 }
      ]
    }
  },
  {
    "type": "mapgen",
    "method": "json",
    "om_terrain": [ [ "pangaea_FIELD_1_roof", "pangaea_FIELD_2_roof" ], [ "pangaea_FIELD_3_roof", "pangaea_FIELD_4_roof" ] ],
    "object": {
      "fill_ter": "t_flat_roof",
      "rows": [
        "              -----------------------------     ",
        "              -...........................-     ",
        "              -...........................-     ",
        "              -...........................-     ",
        "              -...........................-     ",
        "              -...........................-     ",
        "              -...........................-     ",
        "              -............&&.A.X.........-     ",
        "              -............&&.A.N.........-     ",
        "              -...........................-     ",
        "--------------5...........................5-----",
        "-..............................................-",
        "-..............................................-",
        "-..............................................-",
        "-..............................................-",
        "-..............................................-",
        "-..............................................-",
        "-.........................................------",
        "-.........................................-     ",
        "-.........................................-     ",
        "-.........................................-     ",
        "-.........................................-     ",
        "-.........................................-     ",
        "-.........................................-     ",
        "-.........................................-     ",
        "-.........................................-     ",
        "-.........................................-     ",
        "-.......................-------------------     ",
        "-.......................-                       ",
        "-.......................-                       ",
        "-.......................-                       ",
        "-...................5----                       ",
        "-...................-                           ",
        "-...................-                           ",
        "-...................-                           ",
        "-...................-                           ",
        "-.............-------                           ",
        "-.............-                                 ",
        "-.............-                                 ",
        "-.............-                                 ",
        "-.........-----                                 ",
        "-.........-                                     ",
        "-----------                                     ",
        "                                                ",
        "                                                ",
        "                                                ",
        "                                                ",
        "                                                "
      ],
      "palettes": [ "roof_palette" ]
    }
  }
]
