[
  {
    "type": "mapgen",
    "method": "json",
    "om_terrain": [ [ "pangaea_FIELD_1", "pangaea_FIELD_2" ], [ "pangaea_FIELD_3", "pangaea_FIELD_4" ] ],
    "object": {
      "fill_ter": "t_linoleum_white",
      "rows": [
        "..............#############################.....",
        "...!.......!..#,,,,,#bbbbbb#,,uuuu,MMM,OOO#.....",
        "..............#,,,,,#,,,,,,#,,,,,,,MCM,,,,#...!.",
        "..............#,,,,,#,,,,,,#,,,,,0,,,,,,,,#.....",
        "..............#^,,,,#,,,,,,#/,,/,00,,000,,#.....",
        "..........!...#^,,,,D,,,,,,#/mn/,00,,00,,,#!....",
        "...!..........#^,,,,#,,,,,,#/,,/,00,,00,,2#.....",
        "..............#,,,,,#,,,,,b#/mn/,,,,,,,,4M#.....",
        ".........!....#,,,,,#b,,,,b#/,,/,,,,,,,,,V#.....",
        ".............1#,,,,,#b,,,,b#,,,,,,VV,,,,,,#1....",
        "#####################b,,,,b##########D##########",
        "#,HHHHHHHHHHHFFFFF,,#b,,,,b#s00000sFF,FFs00000s#",
        "#,,,,,,,,,,,,,,,,,,,#b,,,,,#,,,,,,,,,,,,,,,,,,,#",
        "#,HHHHHHHHHHHFFFFF,,#,,,,,,D,,,,,,,,,,,,,,,,,,,#",
        "#,,,,,,,,,,,,,,,,,,,D,,,,,,D,,,,,,,,,,,,,,,,,,,#",
        "#,,,,,,,,,,,,,,,,,,,D,,,,,,#,,,,,,,,,,,,,,,,,,,#",
        "#,HHHHHHHHHHHFFFFF,,#,,,,,b#s00000sFF,FFs00000s#",
        "#,,,,,,,,,,,,,,,,,,,#b,,,,b##########D##########",
        "#,HHHHHHHHHHHFFFFF,,#b,,,,b#,,,,,,VV,,,000#.....",
        "#####################b,,,,b#/,,/,,,,,,,,,0#.....",
        "#,ccc,,,,,,f/#t#t#t####DD###/mn/,,,,,,00,0#.....",
        "w,eee,,hhh,,9#d#d#d##l,,,,l#/,,/,0000,00,0#.....",
        "w,,,,,,zzz,,9#,,,,,s#l,,,,l#/mn/,0,,0,00,,#.....",
        "w,,,,,,zzz,,,d,bbb,s#l,,,,l#/,,/,0,,0,0,,,#.!...",
        "w,,,,,,hhh,,,#,,,,,s#l,,,,l#u,,,,,,,,,,,MM#.....",
        "w,,,,,,,,,,,,#d#d#d##l,,,,l#u,,MCM,,4,,MMM#.....",
        "#llllll,,TTTT#S#S#S##l,,,,l#u,,MMM,VM3,MMM#.....",
        "########d#############D####################.....",
        "wb,bb,b,,,,,,,,,,,,,#,,,#xxxxxxxxxxxxxxxxxxxxxxx",
        "wb,bb,b,,,,,,,,,,,,,D,,,#xxxxxxxxxxxxxxxxxxxxxxx",
        "wb,bb,b,,,,,,,,,,,,,#,,,#xxxxxxxxxxxxxxxxxxxxxxx",
        "wb,bb,b,,,,,,,###d#######xxxxxxxxxxxxxxxxxxxxxxx",
        "wb,bb,b,,,,,,b#BB,TY#1..-yyyyyyxxxxxxxxxxxyyyyyy",
        "wb,bb,b,,,,,,b#,,,,_#...-xxxxxxxxxxxxxxxxxxxxxxx",
        "wb,bb,b,,,,,,b#,,,h_#...-xxxxxxxxxxxxxxxxxxxxxxx",
        "w,,,,,,,,,,,,b#_____#...-xxxxxxxxxxxxxxxxxxxxxxx",
        "###d#[[[[[##d##wwwww#...-xxxxxxxxxxxxxxxxxxxxxxx",
        "w,,,,,,,__[,,,#.........-yyyyyyxxxxxxxxxxxyyyyyy",
        "w,T,T,T,h_[,,,#.......!.-xxxxxxxxxxxxxxxxxxxxxxx",
        "w,T,T,T,,_[,,,#.........-xxxxxxxxxxxxxxxxxxxxxxx",
        "w,T,T,T,,_#wdw#.........-xxxxxxxxxxxxxxxxxxxxxxx",
        "w,T,T,T,,_#---....!.....-xxxxxxxxxxxxxxxxxxxxxxx",
        "###########.-...........-yyyyyyxxxxxxxxxxxyyyyyy",
        "............-...........-xxxxxxxxxxxxxxxxxxxxxxx",
        "..!.........-...........-xxxxxxxxxxxxxxxxxxxxxxx",
        "............-------------xxxxxxxxxxxxxxxxxxxxxxx",
        ".........!..............-xxxxxxxxxxxxxxxxxxxxxxx",
        "........................-yyyyyyxxxxxxxxxxxyyyyyy"
      ],
      "palettes": [ "palette_pangaea_FIELD" ],
      "place_item": [
        { "item": "microscope", "x": 28, "y": 5 },
        { "item": "microscope", "x": 28, "y": 7 },
        { "item": "microscope", "x": 31, "y": 5 },
        { "item": "microscope", "x": 31, "y": 7 },
        { "item": "microscope", "x": 28, "y": 20 },
        { "item": "microscope", "x": 28, "y": 22 },
        { "item": "microscope", "x": 31, "y": 20 },
        { "item": "microscope", "x": 31, "y": 22 },
        { "item": "DNA_analyzer", "x": 40, "y": 7 },
        { "item": "gaia_nest", "x": 36, "y": 25 },
        { "item": "microwave", "x": 12, "y": 20 }
      ],
      "items": {
        "T": [ { "item": "unisex_coat_rack", "chance": 35 } ],
        "F": [ { "item": "FIELD_sample", "chance": 15, "repeat": [ 1, 4 ] } ],
        "H": [ { "item": "FIELD_storage", "chance": 55 } ],
        "0": [ { "item": "FIELD_chem_counter", "chance": 38 } ],
        "u": [ { "item": "FIELD_chem_counter", "chance": 38 } ],
        "f": [ { "item": "SUS_fridge_bachelor", "chance": 100 } ],
        "9": [ { "item": "breakroom_kitchen_counter", "chance": 100, "repeat": [ 2, 9 ] } ],
        "z": [ { "item": "breakroom_kitchen_table", "chance": 25 } ],
        "_": [ { "item": "SUS_office_desk", "chance": 20 } ],
        "B": [ { "item": "lab_bookshelves", "chance": 60, "repeat": 2 } ],
        "2": [ { "item": "fossil_any", "chance": 100, "repeat": [ 3, 12 ] } ],
        "3": [ { "item": "FIELD_genome", "chance": 100, "repeat": [ 3, 12 ] } ]
      }
    }
  },
  {
    "type": "mapgen",
    "method": "json",
    "om_terrain": [ [ "pangaea_FIELD_1_roof", "pangaea_FIELD_2_roof" ], [ "pangaea_FIELD_3_roof", "pangaea_FIELD_4_roof" ] ],
    "object": {
      "fill_ter": "t_flat_roof",
      "rows": [
        "              -----------------------------     ",
        "              -...........................-     ",
        "              -...........................-     ",
        "              -...........................-     ",
        "              -...........................-     ",
        "              -...........................-     ",
        "              -...........................-     ",
        "              -............&&.A.X.........-     ",
        "              -............&&.A.N.........-     ",
        "              -...........................-     ",
        "--------------5...........................5-----",
        "-..............................................-",
        "-..............................................-",
        "-..............................................-",
        "-..............................................-",
        "-..............................................-",
        "-..............................................-",
        "-.........................................------",
        "-.........................................-     ",
        "-.........................................-     ",
        "-.........................................-     ",
        "-.........................................-     ",
        "-.........................................-     ",
        "-.........................................-     ",
        "-.........................................-     ",
        "-.........................................-     ",
        "-.........................................-     ",
        "-.......................-------------------     ",
        "-.......................-                       ",
        "-.......................-                       ",
        "-.......................-                       ",
        "-...................5----                       ",
        "-...................-                           ",
        "-...................-                           ",
        "-...................-                           ",
        "-...................-                           ",
        "-.............-------                           ",
        "-.............-                                 ",
        "-.............-                                 ",
        "-.............-                                 ",
        "-.........-----                                 ",
        "-.........-                                     ",
        "-----------                                     ",
        "                                                ",
        "                                                ",
        "                                                ",
        "                                                ",
        "                                                "
      ],
      "palettes": [ "roof_palette" ]
    }
  }
]
